alt.atheism	religion
comp.graphics	graphic
comp.os.ms-windows.misc	windows
comp.sys.ibm.pc.hardware	hardware
comp.sys.mac.hardware	hardware
comp.windows.x	windows
misc.forsale	sale
rec.autos	car
rec.motorcycles	motorcycle
rec.sport.baseball	baseball
rec.sport.hockey	hockey
sci.crypt	cryptography
sci.electronics	electronics
sci.med	medicine
sci.space	space
soc.religion.christian	religion
talk.politics.guns	gun
talk.politics.mideast	middle_east
talk.politics.misc	politics
talk.religion.misc	religion